000000000000000000000
022222220202220222220
020000000202020002000
022222222222022222220
020000000000000000000
022222022222222222020
000200000000000002020
022222022222222222220
000200020000000000000
022222020222222222020
020202020200000002020
020202222222022222020
020000020200000202020
020222220222020202020
020200000202020202020
020202222202022202220
000000000002020202020
020202222222020202020
020202000200000000000
022222022222222222220
000000000000000000000
