000000000000000000000
020202022202022222220
020202020002020200000
020222022222220202220
020202020000000202020
020202022222220222020
020200020200000000000
022202020202022222020
000202020202020000020
022222220222222222220
000000000000000000020
022222222222222222020
000000000000000002020
022202222222222222220
020000000002000000000
020202222222020222220
020202020002020200000
020202022202222202020
020202000200020202020
022222022202220222220
000000000000000000000
