000000000000000000000
020202222222222222220
020202000000000000000
022202222202222222220
020202020202000000000
020202020222222202020
020200000000000202020
020202222222222222020
020200020200000000020
020222220222222222020
020002000000000002020
020222020202220222220
020202020202020000020
020202022222022222220
020202020000000002020
020202022222022222020
020002000200020002020
020222022222020222020
020202000002020002020
020202022222020222020
000000000000000000000
