000000000000000000000
020202022222222222220
020202000002000000000
020222022202222222220
020200020202000002020
020202020202022222020
020202020202020000000
020202020222022222220
020202000000000000020
020222022222022222220
020202020002020000000
020202022202020202020
020202020202020202020
020202020202020202020
020202020202020202020
022202020202022222220
020002020202000200020
020202020202222202220
020202020200020000000
022202220202222222220
000000000000000000000
