000000000000000000000
022222220222022222220
000000020200020002000
022222220222020222220
000000020200020200020
022222222222020222020
020002000000020202020
020222222222020202020
000000020202020202020
022222220202020202020
000000020202020202020
022222220202220202020
000000020000000000020
022222220202222222220
000002000202020000000
022222220202022222220
020002020202020000000
020202020222022222220
020202020200000000000
020222020222222222220
000000000000000000000
