000000000000000000000
020222220202222222220
020000020202000000020
020222020202022202220
020002020202020200020
020222022202020202020
020002020202020202020
020222220202020222220
020200000202020200000
020222220202020222220
020200020202020202020
020222020222020202020
020002020200000000000
020222020222022222220
020002020002020200000
020202020222220222220
020202020000000200020
020222020202222222020
020002020202020000000
022222020222022222220
000000000000000000000
