000000000000000000000
020202222222222202220
020200020000000002020
020202222222222202020
020202000202000202020
020202022202022202020
020202000000020202020
020202022222220202020
020202020200020202020
020222020202020222020
020202020202020200000
022202020202020202220
000002020202020202000
022202020202220222220
000202020200020200000
022222020202220222220
000000000002020200000
022222222202020202220
000000000202020200020
022222222222020222220
000000000000000000000
